//MAP CONVERTED BY dmm2tgm.py THIS HEADER COMMENT PREVENTS RECONVERSION, DO NOT REMOVE
"af" = (
/obj/structure/table,
/obj/item/book/manual/wiki/security_space_law,
/turf/open/floor/mineral/plastitanium/red/brig,
/area/shuttle/escape)
"aj" = (
/obj/effect/turf_decal/tile/neutral{
	dir = 4
	},
/obj/effect/turf_decal/tile/neutral,
/obj/effect/turf_decal/tile/neutral{
	dir = 1
	},
/obj/effect/turf_decal/tile/neutral{
	dir = 8
	},
/turf/open/floor/plasteel,
/area/shuttle/escape)
"bd" = (
/obj/structure/extinguisher_cabinet{
	pixel_x = -28
	},
/obj/structure/table,
/obj/item/reagent_containers/food/snacks/chocolatebar{
	pixel_x = -4;
	pixel_y = 4
	},
/obj/item/reagent_containers/food/snacks/chocolatebar,
/obj/item/reagent_containers/food/snacks/chocolatebar{
	pixel_x = 4;
	pixel_y = -4
	},
/turf/open/floor/plasteel,
/area/shuttle/escape)
"bw" = (
/obj/effect/turf_decal/tile/red{
	dir = 1
	},
/obj/effect/turf_decal/tile/red,
/obj/effect/turf_decal/tile/red{
	dir = 4
	},
/obj/effect/turf_decal/tile/red{
	dir = 8
	},
/turf/open/floor/plasteel/dark,
/area/shuttle/escape)
"bz" = (
/obj/structure/window/reinforced/tinted{
	dir = 8
	},
/turf/open/floor/plasteel/dark,
/area/shuttle/escape)
"ck" = (
/obj/structure/toilet,
/turf/open/floor/plasteel/freezer,
/area/shuttle/escape)
"cl" = (
/obj/structure/toilet,
/obj/machinery/light/small{
	dir = 1
	},
/turf/open/floor/plasteel/freezer,
/area/shuttle/escape)
"co" = (
/turf/closed/wall/mineral/titanium,
/area/shuttle/escape)
"cx" = (
/obj/structure/window/reinforced/tinted,
/turf/open/floor/plasteel/dark,
/area/shuttle/escape)
"cI" = (
/obj/effect/turf_decal/tile/red{
	dir = 1
	},
/obj/effect/turf_decal/tile/red,
/obj/effect/turf_decal/tile/red{
	dir = 4
	},
/obj/effect/turf_decal/tile/red{
	dir = 8
	},
/obj/structure/curtain,
/turf/open/floor/plasteel/dark,
/area/shuttle/escape)
"dm" = (
/obj/machinery/computer/med_data{
	dir = 4
	},
/obj/effect/turf_decal/tile/blue{
	dir = 8
	},
/obj/effect/turf_decal/tile/blue{
	dir = 4
	},
/obj/effect/turf_decal/tile/blue{
	dir = 1
	},
/obj/effect/turf_decal/tile/blue,
/turf/open/floor/plasteel/dark,
/area/shuttle/escape)
"dw" = (
/obj/effect/turf_decal/tile/blue{
	dir = 1
	},
/obj/effect/turf_decal/tile/blue,
/obj/effect/turf_decal/tile/blue{
	dir = 4
	},
/obj/effect/turf_decal/tile/blue{
	dir = 8
	},
/turf/open/floor/plasteel/dark,
/area/shuttle/escape)
"dz" = (
/turf/open/floor/plating,
/area/shuttle/escape)
"ei" = (
/obj/machinery/computer/secure_data{
	dir = 8
	},
/obj/effect/turf_decal/tile/red{
	dir = 4
	},
/obj/effect/turf_decal/tile/red{
	dir = 8
	},
/obj/effect/turf_decal/tile/red{
	dir = 1
	},
/obj/effect/turf_decal/tile/red,
/turf/open/floor/plasteel/dark,
/area/shuttle/escape)
"er" = (
/obj/structure/urinal{
	pixel_y = -32
	},
/turf/open/floor/plasteel/freezer,
/area/shuttle/escape)
"ex" = (
/obj/effect/turf_decal/tile/purple{
	dir = 1
	},
/obj/effect/turf_decal/tile/purple,
/obj/effect/turf_decal/tile/purple{
	dir = 4
	},
/obj/effect/turf_decal/tile/purple{
	dir = 8
	},
/obj/machinery/computer/aifixer,
/obj/machinery/light/small{
	dir = 1
	},
/turf/open/floor/plasteel/dark,
/area/shuttle/escape)
"eZ" = (
/obj/machinery/computer/crew{
	dir = 4
	},
/obj/effect/turf_decal/tile/blue{
	dir = 8
	},
/obj/effect/turf_decal/tile/blue{
	dir = 4
	},
/obj/effect/turf_decal/tile/blue{
	dir = 1
	},
/obj/effect/turf_decal/tile/blue,
/turf/open/floor/plasteel/dark,
/area/shuttle/escape)
"fg" = (
/obj/effect/turf_decal/tile/blue{
	dir = 1
	},
/obj/effect/turf_decal/tile/blue,
/obj/effect/turf_decal/tile/blue{
	dir = 4
	},
/obj/effect/turf_decal/tile/blue{
	dir = 8
	},
/obj/structure/toilet{
	dir = 8
	},
/obj/item/radio/intercom{
	name = "Station Intercom (General)";
	pixel_y = -29
	},
/obj/machinery/light/small{
	dir = 4
	},
/turf/open/floor/plasteel/dark,
/area/shuttle/escape)
"fZ" = (
/obj/effect/turf_decal/tile/purple{
	dir = 1
	},
/obj/effect/turf_decal/tile/purple,
/obj/effect/turf_decal/tile/purple{
	dir = 4
	},
/obj/effect/turf_decal/tile/purple{
	dir = 8
	},
/obj/structure/curtain,
/turf/open/floor/plasteel/dark,
/area/shuttle/escape)
"gB" = (
/obj/machinery/flasher{
	id = "shuttle_flasher";
	pixel_x = -24;
	pixel_y = 6
	},
/obj/structure/table,
/obj/item/storage/box/zipties,
/obj/machinery/button/flasher{
	id = "shuttle_flasher";
	pixel_x = -24;
	pixel_y = -6
	},
/turf/open/floor/mineral/plastitanium/red/brig,
/area/shuttle/escape)
"gF" = (
/obj/structure/extinguisher_cabinet{
	pixel_y = -30
	},
/turf/open/floor/plasteel/dark,
/area/shuttle/escape)
"gU" = (
/obj/structure/chair/comfy/shuttle{
	dir = 1
	},
/turf/open/floor/plasteel/dark,
/area/shuttle/escape)
"gZ" = (
/obj/machinery/light{
	dir = 8
	},
/turf/open/floor/plasteel,
/area/shuttle/escape)
"hn" = (
/turf/open/floor/plasteel,
/area/shuttle/escape)
"hu" = (
/obj/structure/toilet{
	dir = 4
	},
/obj/structure/reagent_dispensers/peppertank{
	pixel_x = -32
	},
/turf/open/floor/mineral/plastitanium/red/brig,
/area/shuttle/escape)
"hE" = (
/obj/structure/table,
/obj/item/paper_bin,
/obj/item/pen,
/obj/effect/turf_decal/tile/purple{
	dir = 4
	},
/obj/effect/turf_decal/tile/purple{
	dir = 1
	},
/obj/effect/turf_decal/tile/purple,
/obj/effect/turf_decal/tile/purple{
	dir = 8
	},
/turf/open/floor/plasteel/dark,
/area/shuttle/escape)
"ig" = (
/obj/structure/sink{
	dir = 4;
	pixel_x = 12;
	pixel_y = 2
	},
/obj/structure/mirror{
	pixel_x = 28
	},
/turf/open/floor/plasteel,
/area/shuttle/escape)
"iz" = (
/obj/structure/toilet{
	dir = 8
	},
/obj/machinery/light/small{
	dir = 4
	},
/turf/open/floor/plasteel/freezer,
/area/shuttle/escape)
"iD" = (
/turf/open/floor/plasteel/freezer,
/area/shuttle/escape)
"iI" = (
/obj/structure/table,
/obj/machinery/recharger,
/turf/open/floor/mineral/plastitanium/red/brig,
/area/shuttle/escape)
"iL" = (
/obj/structure/table,
/obj/structure/bedsheetbin/towel,
/turf/open/floor/plasteel,
/area/shuttle/escape)
"iQ" = (
/obj/machinery/door/airlock{
	name = "Restroom"
	},
/obj/effect/turf_decal/tile/neutral{
	dir = 4
	},
/obj/effect/turf_decal/tile/neutral,
/obj/effect/turf_decal/tile/neutral{
	dir = 1
	},
/obj/effect/turf_decal/tile/neutral{
	dir = 8
	},
/turf/open/floor/plasteel,
/area/shuttle/escape)
"ji" = (
/obj/machinery/light,
/obj/structure/table,
/obj/machinery/recharger,
/turf/open/floor/plasteel/dark,
/area/shuttle/escape)
"jY" = (
/obj/item/twohanded/required/kirbyplants{
	icon_state = "plant-21"
	},
/turf/open/floor/plasteel/dark,
/area/shuttle/escape)
"kg" = (
/obj/machinery/light,
/obj/structure/table,
/obj/item/storage/firstaid/regular{
	pixel_x = 2;
	pixel_y = 3
	},
/obj/item/storage/firstaid/o2,
/turf/open/floor/plasteel/dark,
/area/shuttle/escape)
"kA" = (
/obj/machinery/shower{
	pixel_y = 16
	},
/turf/open/floor/plasteel/freezer,
/area/shuttle/escape)
"kV" = (
/obj/machinery/computer/security{
	dir = 8
	},
/obj/effect/turf_decal/tile/red{
	dir = 4
	},
/obj/effect/turf_decal/tile/red{
	dir = 8
	},
/obj/effect/turf_decal/tile/red{
	dir = 1
	},
/obj/effect/turf_decal/tile/red,
/turf/open/floor/plasteel/dark,
/area/shuttle/escape)
"lr" = (
/obj/structure/toilet{
	dir = 1
	},
/obj/machinery/light/small,
/turf/open/floor/plasteel/freezer,
/area/shuttle/escape)
"lH" = (
/obj/machinery/door/airlock/public/glass{
	name = "Emergency Shuttle Cockpit";
	req_access_txt = "19"
	},
/turf/open/floor/plasteel/dark,
/area/shuttle/escape)
"lR" = (
/obj/structure/sink{
	dir = 8;
	pixel_x = -12;
	pixel_y = 2
	},
/obj/structure/mirror{
	pixel_x = -28
	},
/turf/open/floor/plasteel,
/area/shuttle/escape)
"mb" = (
/obj/machinery/shower{
	dir = 1
	},
/turf/open/floor/plasteel/freezer,
/area/shuttle/escape)
"mI" = (
/obj/structure/toilet,
/obj/structure/window/reinforced/tinted{
	dir = 4
	},
/obj/machinery/light/small{
	dir = 1
	},
/turf/open/floor/plasteel/freezer,
/area/shuttle/escape)
"nd" = (
/obj/structure/window/reinforced{
	dir = 1
	},
/obj/structure/shuttle/engine/heater,
/turf/open/floor/plating/airless,
/area/shuttle/escape)
"nP" = (
/obj/structure/sink/puddle,
/turf/open/floor/plasteel/freezer,
/area/shuttle/escape)
"oj" = (
/obj/item/twohanded/required/kirbyplants{
	icon_state = "plant-21"
	},
/obj/machinery/light{
	dir = 4
	},
/turf/open/floor/plasteel,
/area/shuttle/escape)
"op" = (
/obj/structure/window/reinforced/tinted,
/obj/structure/curtain,
/turf/open/floor/plasteel/dark,
/area/shuttle/escape)
"ox" = (
/obj/machinery/power/port_gen/pacman,
/turf/open/floor/plating,
/area/shuttle/escape)
"pD" = (
/obj/structure/toilet,
/obj/structure/window/reinforced/tinted{
	dir = 8
	},
/obj/machinery/light/small{
	dir = 1
	},
/turf/open/floor/plasteel/freezer,
/area/shuttle/escape)
"pT" = (
/turf/closed/wall/mineral/titanium/nodiagonal,
/area/shuttle/escape)
"pX" = (
/obj/structure/toilet{
	dir = 1
	},
/obj/effect/turf_decal/tile/purple{
	dir = 4
	},
/obj/effect/turf_decal/tile/purple{
	dir = 1
	},
/obj/effect/turf_decal/tile/purple,
/obj/effect/turf_decal/tile/purple{
	dir = 8
	},
/turf/open/floor/plasteel/dark,
/area/shuttle/escape)
"pZ" = (
/obj/effect/turf_decal/tile/yellow{
	dir = 1
	},
/obj/effect/turf_decal/tile/yellow,
/obj/effect/turf_decal/tile/yellow{
	dir = 4
	},
/obj/effect/turf_decal/tile/yellow{
	dir = 8
	},
/obj/structure/curtain,
/turf/open/floor/plasteel/dark,
/area/shuttle/escape)
"qr" = (
/obj/structure/reagent_dispensers/water_cooler,
/obj/effect/turf_decal/tile/neutral{
	dir = 4
	},
/obj/effect/turf_decal/tile/neutral{
	dir = 8
	},
/obj/effect/turf_decal/tile/neutral{
	dir = 1
	},
/obj/effect/turf_decal/tile/neutral,
/turf/open/floor/plasteel,
/area/shuttle/escape)
"rc" = (
/obj/structure/toilet{
	dir = 4
	},
/obj/machinery/light/small{
	dir = 8
	},
/turf/open/floor/plasteel/freezer,
/area/shuttle/escape)
"rR" = (
/obj/structure/table,
/obj/item/storage/firstaid/regular{
	pixel_x = 2;
	pixel_y = 3
	},
/obj/machinery/light{
	dir = 4
	},
/turf/open/floor/plasteel,
/area/shuttle/escape)
"rY" = (
/obj/machinery/door/airlock{
	name = "Showers"
	},
/turf/open/floor/plasteel,
/area/shuttle/escape)
"sW" = (
/obj/machinery/light{
	dir = 1
	},
/obj/structure/toilet,
/turf/open/floor/mineral/plastitanium/red/brig,
/area/shuttle/escape)
"tc" = (
/obj/structure/reagent_dispensers/fueltank,
/turf/open/floor/plating,
/area/shuttle/escape)
"tu" = (
/obj/structure/chair/comfy/shuttle{
	dir = 4
	},
/obj/effect/turf_decal/tile/neutral{
	dir = 4
	},
/obj/effect/turf_decal/tile/neutral{
	dir = 8
	},
/obj/effect/turf_decal/tile/neutral{
	dir = 1
	},
/obj/effect/turf_decal/tile/neutral,
/turf/open/floor/plasteel,
/area/shuttle/escape)
"tY" = (
/obj/structure/toilet{
	dir = 1
	},
/obj/structure/window/reinforced/tinted{
	dir = 4
	},
/obj/machinery/light/small,
/turf/open/floor/plasteel/freezer,
/area/shuttle/escape)
"uh" = (
/obj/structure/toilet{
	dir = 1
	},
/obj/structure/window/reinforced/tinted{
	dir = 8
	},
/obj/machinery/light/small,
/turf/open/floor/plasteel/freezer,
/area/shuttle/escape)
"vp" = (
/obj/machinery/computer/card{
	dir = 4
	},
/obj/structure/window/reinforced/tinted{
	dir = 8
	},
/obj/machinery/light/small{
	dir = 1
	},
/turf/open/floor/plasteel/dark,
/area/shuttle/escape)
"vx" = (
/obj/machinery/door/airlock/maintenance_hatch,
/turf/open/floor/plating,
/area/shuttle/escape)
"vB" = (
/obj/item/radio/intercom{
	dir = 8;
	name = "Station Intercom (General)";
	pixel_x = 27
	},
/turf/open/floor/plasteel,
/area/shuttle/escape)
"vO" = (
/obj/effect/turf_decal/tile/blue{
	dir = 1
	},
/obj/effect/turf_decal/tile/blue,
/obj/effect/turf_decal/tile/blue{
	dir = 4
	},
/obj/effect/turf_decal/tile/blue{
	dir = 8
	},
/obj/structure/curtain,
/turf/open/floor/plasteel/dark,
/area/shuttle/escape)
"wB" = (
/obj/machinery/computer/communications{
	dir = 8
	},
/obj/structure/window/reinforced/tinted{
	dir = 4
	},
/obj/structure/window/reinforced/tinted,
/turf/open/floor/plasteel/dark,
/area/shuttle/escape)
"xa" = (
/obj/machinery/light,
/turf/open/floor/plasteel/freezer,
/area/shuttle/escape)
"xO" = (
/obj/machinery/light/small{
	dir = 4
	},
/obj/machinery/recharge_station,
/turf/open/floor/plasteel/freezer,
/area/shuttle/escape)
"Ar" = (
/obj/structure/table,
/obj/item/storage/box/cups,
/obj/effect/turf_decal/tile/neutral{
	dir = 4
	},
/obj/effect/turf_decal/tile/neutral{
	dir = 8
	},
/obj/effect/turf_decal/tile/neutral{
	dir = 1
	},
/obj/effect/turf_decal/tile/neutral,
/turf/open/floor/plasteel,
/area/shuttle/escape)
"At" = (
/turf/template_noop,
/area/template_noop)
"Bb" = (
/obj/structure/bed,
/obj/effect/turf_decal/tile/neutral{
	dir = 4
	},
/obj/effect/turf_decal/tile/neutral,
/obj/effect/turf_decal/tile/neutral{
	dir = 1
	},
/obj/effect/turf_decal/tile/neutral{
	dir = 8
	},
/turf/open/floor/plasteel,
/area/shuttle/escape)
"Bq" = (
/obj/machinery/door/airlock{
	name = "Bathroom"
	},
/turf/open/floor/plasteel/freezer,
/area/shuttle/escape)
"Bt" = (
/obj/structure/shuttle/engine/propulsion,
/turf/open/floor/plating/airless,
/area/shuttle/escape)
"BM" = (
/obj/item/radio/intercom{
	name = "Station Intercom (General)";
	pixel_y = -29
	},
/turf/open/floor/plasteel,
/area/shuttle/escape)
"CQ" = (
/obj/structure/window/reinforced/tinted{
	dir = 4
	},
/turf/open/floor/plasteel/dark,
/area/shuttle/escape)
"Db" = (
/obj/machinery/light,
/turf/open/floor/plasteel,
/area/shuttle/escape)
"DS" = (
/obj/effect/spawner/structure/window/shuttle,
/turf/open/floor/plating,
/area/shuttle/escape)
"FB" = (
/obj/machinery/computer/emergency_shuttle{
	dir = 8
	},
/obj/structure/window/reinforced/tinted{
	dir = 4
	},
/obj/machinery/light/small{
	dir = 1
	},
/turf/open/floor/plasteel/dark,
/area/shuttle/escape)
"Gr" = (
/obj/item/twohanded/required/kirbyplants{
	icon_state = "plant-21"
	},
/obj/effect/turf_decal/tile/neutral{
	dir = 4
	},
/obj/effect/turf_decal/tile/neutral{
	dir = 8
	},
/obj/effect/turf_decal/tile/neutral{
	dir = 1
	},
/obj/effect/turf_decal/tile/neutral,
/turf/open/floor/plasteel,
/area/shuttle/escape)
"Gz" = (
/obj/item/radio/intercom{
	dir = 4;
	name = "Station Intercom (General)";
	pixel_x = -27
	},
/obj/effect/turf_decal/tile/neutral{
	dir = 4
	},
/obj/effect/turf_decal/tile/neutral,
/obj/effect/turf_decal/tile/neutral{
	dir = 1
	},
/obj/effect/turf_decal/tile/neutral{
	dir = 8
	},
/turf/open/floor/plasteel,
/area/shuttle/escape)
"GN" = (
/obj/machinery/power/smes/engineering,
/turf/open/floor/plating,
/area/shuttle/escape)
"Hx" = (
/obj/structure/extinguisher_cabinet{
	pixel_y = -30
	},
/turf/open/floor/plasteel,
/area/shuttle/escape)
"HB" = (
/obj/structure/urinal{
	pixel_x = -32
	},
/turf/open/floor/plasteel/freezer,
/area/shuttle/escape)
"IK" = (
/obj/structure/window/reinforced/tinted{
	dir = 8
	},
/obj/structure/window/reinforced/tinted,
/turf/open/floor/plasteel/dark,
/area/shuttle/escape)
"IU" = (
/obj/structure/sign/warning/electricshock{
	pixel_x = 32
	},
/turf/open/floor/plasteel,
/area/shuttle/escape)
"Jh" = (
/obj/structure/sign/warning/enginesafety{
	pixel_y = 32
	},
/turf/open/floor/plating,
/area/shuttle/escape)
"Jp" = (
/obj/machinery/flasher{
	id = "shuttle_flasher";
	pixel_x = 24;
	pixel_y = 6
	},
/obj/structure/toilet{
	dir = 8
	},
/turf/open/floor/mineral/plastitanium/red/brig,
/area/shuttle/escape)
"Kd" = (
/obj/machinery/door/airlock{
	name = "Men's Restroom"
	},
/turf/open/floor/plasteel/freezer,
/area/shuttle/escape)
"KZ" = (
/obj/effect/turf_decal/tile/yellow{
	dir = 1
	},
/obj/effect/turf_decal/tile/yellow,
/obj/effect/turf_decal/tile/yellow{
	dir = 4
	},
/obj/effect/turf_decal/tile/yellow{
	dir = 8
	},
/obj/machinery/computer/station_alert,
/obj/machinery/light/small{
	dir = 1
	},
/turf/open/floor/plasteel/dark,
/area/shuttle/escape)
"NB" = (
/obj/machinery/door/airlock/public/glass,
/turf/open/floor/plasteel/dark,
/area/shuttle/escape)
"Or" = (
/obj/structure/table,
/obj/item/storage/toolbox/emergency,
/obj/item/crowbar,
/obj/effect/turf_decal/tile/yellow,
/obj/effect/turf_decal/tile/yellow{
	dir = 1
	},
/obj/effect/turf_decal/tile/yellow{
	dir = 4
	},
/obj/effect/turf_decal/tile/yellow{
	dir = 8
	},
/turf/open/floor/plasteel/dark,
/area/shuttle/escape)
"Pc" = (
/obj/structure/toilet{
	dir = 4
	},
/turf/open/floor/mineral/plastitanium/red/brig,
/area/shuttle/escape)
"Pv" = (
/obj/machinery/light/small{
	dir = 1
	},
/turf/open/floor/plating,
/area/shuttle/escape)
"PP" = (
/turf/open/floor/plasteel/dark,
/area/shuttle/escape)
"QM" = (
/obj/effect/turf_decal/tile/red{
	dir = 1
	},
/obj/effect/turf_decal/tile/red,
/obj/effect/turf_decal/tile/red{
	dir = 4
	},
/obj/effect/turf_decal/tile/red{
	dir = 8
	},
/obj/item/radio/intercom{
	name = "Station Intercom (General)";
	pixel_y = -29
	},
/obj/structure/toilet{
	dir = 4
	},
/obj/machinery/light/small{
	dir = 8
	},
/turf/open/floor/plasteel/dark,
/area/shuttle/escape)
"QT" = (
/obj/structure/closet/crate/bin,
/obj/effect/turf_decal/tile/neutral{
	dir = 4
	},
/obj/effect/turf_decal/tile/neutral,
/obj/effect/turf_decal/tile/neutral{
	dir = 1
	},
/obj/effect/turf_decal/tile/neutral{
	dir = 8
	},
/obj/machinery/light{
	dir = 4
	},
/turf/open/floor/plasteel,
/area/shuttle/escape)
"RV" = (
/obj/structure/toilet{
	dir = 8
	},
/obj/structure/window/reinforced/tinted{
	dir = 4
	},
/turf/open/floor/plasteel/dark,
/area/shuttle/escape)
"Sl" = (
/obj/structure/toilet{
	dir = 1
	},
/obj/effect/turf_decal/tile/yellow,
/obj/effect/turf_decal/tile/yellow{
	dir = 1
	},
/obj/effect/turf_decal/tile/yellow{
	dir = 4
	},
/obj/effect/turf_decal/tile/yellow{
	dir = 8
	},
/turf/open/floor/plasteel/dark,
/area/shuttle/escape)
"Sz" = (
/obj/structure/reagent_dispensers/watertank,
/turf/open/floor/plating,
/area/shuttle/escape)
"Tq" = (
/obj/machinery/door/airlock/shuttle{
	name = "Emergency Shuttle Airlock"
	},
/obj/docking_port/mobile/emergency{
	dwidth = 15;
	height = 20;
	name = "Emergency bathroom shuttle";
	width = 42
	},
/obj/structure/fans/tiny,
/turf/open/floor/plating,
/area/shuttle/escape)
"Tu" = (
/obj/machinery/light{
	dir = 4
	},
/turf/open/floor/plasteel,
/area/shuttle/escape)
"Tz" = (
/obj/structure/table,
/obj/structure/bedsheetbin/towel,
/obj/effect/turf_decal/tile/neutral{
	dir = 4
	},
/obj/effect/turf_decal/tile/neutral,
/obj/effect/turf_decal/tile/neutral{
	dir = 1
	},
/obj/effect/turf_decal/tile/neutral{
	dir = 8
	},
/turf/open/floor/plasteel,
/area/shuttle/escape)
"VD" = (
/obj/machinery/power/terminal{
	dir = 4
	},
/turf/open/floor/plating,
/area/shuttle/escape)
"Wi" = (
/obj/machinery/door/airlock/shuttle{
	name = "Emergency Shuttle Airlock";
	req_access_txt = "2"
	},
/obj/structure/fans/tiny,
/turf/open/floor/plating,
/area/shuttle/escape)
"WL" = (
/turf/open/floor/mineral/plastitanium/red/brig,
/area/shuttle/escape)
"Xj" = (
/obj/machinery/door/airlock{
	name = "Women's Restroom"
	},
/turf/open/floor/plasteel/freezer,
/area/shuttle/escape)
"Xq" = (
/obj/effect/spawner/structure/window/shuttle,
/turf/open/floor/plasteel/dark,
/area/shuttle/escape)
"XK" = (
/obj/machinery/door/airlock/shuttle{
	name = "Emergency Shuttle Airlock"
	},
/obj/structure/fans/tiny,
/turf/open/floor/plating,
/area/shuttle/escape)
"Yo" = (
/obj/structure/toilet{
	dir = 4
	},
/obj/structure/window/reinforced/tinted{
	dir = 8
	},
/turf/open/floor/plasteel/dark,
/area/shuttle/escape)
"Zn" = (
/obj/machinery/light{
	dir = 4
	},
/turf/open/floor/plasteel/freezer,
/area/shuttle/escape)

(1,1,1) = {"
At
At
At
At
At
At
At
co
co
co
co
co
co
Wi
co
Tq
co
At
At
At
co
XK
co
XK
co
At
At
co
co
DS
DS
DS
DS
DS
co
co
co
co
At
At
At
At
"}
(2,1,1) = {"
At
At
At
At
At
co
co
co
co
iI
Pc
hu
gB
WL
Xq
hn
pT
DS
DS
DS
pT
hn
bd
hn
pT
co
co
pT
qr
tu
tu
tu
Ar
Gr
co
HB
HB
pT
co
co
At
At
"}
(3,1,1) = {"
At
At
co
co
co
co
co
co
co
sW
WL
WL
WL
WL
NB
hn
gZ
hn
hn
hn
gZ
hn
hn
hn
gZ
hn
hn
gZ
hn
hn
vB
hn
hn
hn
Tu
hn
hn
hn
pT
co
co
co
"}
(4,1,1) = {"
At
co
co
co
co
co
dm
eZ
co
af
Jp
iI
WL
WL
Xq
hn
co
ig
ig
ig
co
hn
hn
hn
co
ig
ig
pT
co
co
co
co
co
co
co
pT
hn
hn
er
co
nd
Bt
"}
(5,1,1) = {"
co
co
co
pT
hE
co
dw
fg
co
co
co
co
co
co
pT
hn
pT
co
co
co
pT
hn
hn
hn
pT
co
co
co
rc
co
rc
co
rc
co
rc
co
hn
hn
er
co
nd
Bt
"}
(6,1,1) = {"
At
At
co
ex
pX
co
vO
co
co
aj
Gz
aj
aj
iQ
hn
hn
hn
hn
hn
hn
hn
hn
hn
hn
hn
hn
hn
co
Bq
co
Bq
co
Bq
co
Bq
co
hn
hn
co
co
nd
Bt
"}
(7,1,1) = {"
At
At
co
co
fZ
co
PP
kg
co
Bb
QT
Bb
Tz
co
hn
hn
hn
hn
hn
hn
hn
hn
hn
hn
hn
hn
hn
hn
hn
hn
hn
hn
hn
hn
hn
hn
hn
hn
BM
co
nd
Bt
"}
(8,1,1) = {"
At
At
DS
jY
PP
PP
PP
gF
co
co
co
co
co
pT
hn
hn
hn
hn
hn
hn
co
iL
hn
iL
co
hn
hn
hn
hn
hn
Tu
hn
hn
hn
hn
hn
hn
hn
hn
co
nd
Bt
"}
(9,1,1) = {"
At
At
co
vp
IK
op
PP
PP
co
hn
hn
hn
hn
hn
hn
hn
co
Bq
co
Bq
co
co
rY
co
co
co
co
iD
iD
co
co
pT
Bq
co
Bq
co
hn
hn
hn
co
nd
Bt
"}
(10,1,1) = {"
At
At
co
RV
CQ
cx
PP
PP
lH
hn
hn
hn
hn
hn
hn
hn
co
iz
co
iz
co
kA
iD
mb
co
mI
iD
iD
iD
iD
tY
co
iz
co
iz
co
hn
hn
Db
co
pT
pT
"}
(11,1,1) = {"
At
At
co
Yo
bz
cx
PP
PP
lH
hn
hn
hn
hn
hn
hn
hn
co
co
co
co
co
kA
iD
mb
co
nP
iD
iD
iD
iD
lr
co
co
co
co
co
hn
IU
Hx
co
pT
pT
"}
(12,1,1) = {"
At
At
co
FB
wB
op
PP
gU
co
hn
hn
hn
hn
hn
hn
hn
co
rc
co
rc
co
kA
Zn
mb
co
pD
iD
iD
iD
iD
uh
co
rc
co
rc
co
hn
co
vx
pT
nd
Bt
"}
(13,1,1) = {"
At
At
DS
jY
PP
PP
PP
gU
co
hn
hn
hn
hn
hn
hn
hn
co
Bq
co
Bq
co
co
co
co
co
co
co
iD
iD
co
co
co
Bq
co
Bq
co
hn
co
Jh
tc
nd
Bt
"}
(14,1,1) = {"
At
At
co
co
pZ
co
PP
ji
co
co
co
co
co
pT
hn
hn
hn
hn
hn
hn
Bq
lr
co
cl
Bq
hn
hn
hn
hn
hn
gZ
hn
hn
hn
hn
hn
hn
co
dz
Sz
nd
Bt
"}
(15,1,1) = {"
At
At
co
KZ
Sl
co
cI
co
co
ck
Bq
iD
iD
Kd
hn
hn
hn
hn
hn
hn
pT
co
co
co
pT
hn
hn
hn
hn
hn
hn
hn
hn
hn
hn
hn
hn
co
Pv
ox
nd
Bt
"}
(16,1,1) = {"
co
co
co
pT
Or
co
bw
QM
co
co
co
iD
iD
co
hn
hn
hn
hn
hn
hn
co
lR
lR
lR
co
hn
hn
co
co
co
hn
co
co
co
hn
hn
hn
co
VD
VD
nd
Bt
"}
(17,1,1) = {"
At
co
co
co
co
co
ei
kV
co
ck
Bq
iD
xa
co
hn
hn
hn
hn
hn
hn
hn
hn
hn
hn
hn
hn
hn
co
cl
Bq
hn
Bq
lr
co
hn
Tu
hn
co
GN
GN
nd
Bt
"}
(18,1,1) = {"
At
At
co
co
co
co
co
co
co
co
co
iD
iD
Xj
hn
hn
hn
rR
hn
hn
hn
hn
hn
hn
hn
hn
oj
co
co
co
hn
co
co
co
Bq
co
Bq
co
co
co
co
co
"}
(19,1,1) = {"
At
At
At
At
At
co
co
co
co
ck
Bq
iD
iD
co
hn
hn
pT
co
DS
DS
DS
DS
DS
DS
DS
DS
co
co
cl
Bq
hn
Bq
lr
co
iz
co
xO
co
co
co
At
At
"}
(20,1,1) = {"
At
At
At
At
At
At
At
co
co
co
co
co
co
co
co
co
co
At
At
At
At
At
At
At
At
At
At
co
co
co
DS
co
co
co
co
co
co
co
At
At
At
At
"}
