//MAP CONVERTED BY dmm2tgm.py THIS HEADER COMMENT PREVENTS RECONVERSION, DO NOT REMOVE
"af" = (
/obj/structure/table,
/obj/item/book/manual/wiki/security_space_law,
/turf/open/floor/mineral/plastitanium/red/brig,
/area/shuttle/escape)
"aj" = (
/obj/machinery/light{
	dir = 1
	},
/turf/open/floor/plasteel,
/area/shuttle/escape)
"bd" = (
/obj/structure/extinguisher_cabinet{
	pixel_x = -28
	},
/obj/structure/table,
/obj/item/reagent_containers/food/snacks/chocolatebar{
	pixel_x = -4;
	pixel_y = 4
	},
/obj/item/reagent_containers/food/snacks/chocolatebar,
/obj/item/reagent_containers/food/snacks/chocolatebar{
	pixel_x = 4;
	pixel_y = -4
	},
/turf/open/floor/plasteel,
/area/shuttle/escape)
"bw" = (
/obj/machinery/computer/secure_data{
	dir = 8
	},
/obj/effect/turf_decal/tile/red{
	dir = 1
	},
/obj/effect/turf_decal/tile/red,
/obj/effect/turf_decal/tile/red{
	dir = 4
	},
/obj/effect/turf_decal/tile/red{
	dir = 8
	},
/turf/open/floor/plasteel/dark,
/area/shuttle/escape)
"bz" = (
/obj/effect/turf_decal/tile/neutral{
	dir = 1
	},
/obj/effect/turf_decal/tile/neutral{
	dir = 8
	},
/turf/open/floor/plasteel,
/area/shuttle/escape)
"ck" = (
/obj/structure/toilet,
/turf/open/floor/plasteel/freezer,
/area/shuttle/escape)
"co" = (
/turf/closed/wall/mineral/titanium,
/area/shuttle/escape)
"cx" = (
/obj/effect/turf_decal/tile/blue{
	dir = 1
	},
/obj/effect/turf_decal/tile/blue{
	dir = 4
	},
/turf/open/floor/plasteel/white,
/area/shuttle/escape)
"cI" = (
/obj/structure/chair/comfy/beige{
	dir = 4
	},
/obj/effect/turf_decal/tile/red{
	dir = 1
	},
/obj/effect/turf_decal/tile/red,
/obj/effect/turf_decal/tile/red{
	dir = 4
	},
/obj/effect/turf_decal/tile/red{
	dir = 8
	},
/turf/open/floor/plasteel/dark,
/area/shuttle/escape)
"dm" = (
/obj/structure/reagent_dispensers/water_cooler,
/obj/effect/turf_decal/tile/neutral{
	dir = 1
	},
/obj/effect/turf_decal/tile/neutral,
/obj/effect/turf_decal/tile/neutral{
	dir = 4
	},
/obj/effect/turf_decal/tile/neutral{
	dir = 8
	},
/turf/open/floor/plasteel,
/area/shuttle/escape)
"dw" = (
/obj/machinery/computer/crew{
	dir = 4
	},
/obj/effect/turf_decal/tile/blue{
	dir = 1
	},
/obj/effect/turf_decal/tile/blue,
/obj/effect/turf_decal/tile/blue{
	dir = 4
	},
/obj/effect/turf_decal/tile/blue{
	dir = 8
	},
/turf/open/floor/plasteel/dark,
/area/shuttle/escape)
"dz" = (
/turf/open/floor/plating,
/area/shuttle/escape)
"ei" = (
/obj/machinery/door/airlock/public/glass{
	name = "Emergency Shuttle Cockpit";
	req_access_txt = "19"
	},
/turf/open/floor/plasteel/dark,
/area/shuttle/escape)
"er" = (
/obj/structure/urinal{
	pixel_y = -32
	},
/turf/open/floor/plasteel,
/area/shuttle/escape)
"ex" = (
/obj/structure/table,
/obj/item/storage/toolbox/emergency,
/obj/item/crowbar,
/obj/machinery/light{
	dir = 1
	},
/obj/effect/turf_decal/tile/purple{
	dir = 1
	},
/obj/effect/turf_decal/tile/purple,
/obj/effect/turf_decal/tile/purple{
	dir = 4
	},
/obj/effect/turf_decal/tile/purple{
	dir = 8
	},
/turf/open/floor/plasteel/dark,
/area/shuttle/escape)
"eZ" = (
/obj/machinery/computer/cargo/request,
/obj/effect/turf_decal/tile/yellow{
	dir = 1
	},
/obj/effect/turf_decal/tile/yellow,
/obj/effect/turf_decal/tile/yellow{
	dir = 4
	},
/obj/effect/turf_decal/tile/yellow{
	dir = 8
	},
/turf/open/floor/plasteel/dark,
/area/shuttle/escape)
"fg" = (
/obj/effect/turf_decal/tile/blue,
/obj/effect/turf_decal/tile/blue{
	dir = 8
	},
/turf/open/floor/plasteel/white,
/area/shuttle/escape)
"fZ" = (
/obj/structure/chair/comfy/beige{
	dir = 1
	},
/obj/effect/turf_decal/tile/purple{
	dir = 1
	},
/obj/effect/turf_decal/tile/purple,
/obj/effect/turf_decal/tile/purple{
	dir = 4
	},
/obj/effect/turf_decal/tile/purple{
	dir = 8
	},
/turf/open/floor/plasteel/dark,
/area/shuttle/escape)
"gB" = (
/obj/machinery/flasher{
	id = "shuttle_flasher";
	pixel_x = -24;
	pixel_y = 6
	},
/obj/structure/table,
/obj/item/storage/box/zipties,
/obj/machinery/button/flasher{
	id = "shuttle_flasher";
	pixel_x = -24;
	pixel_y = -6
	},
/turf/open/floor/mineral/plastitanium/red/brig,
/area/shuttle/escape)
"gF" = (
/obj/machinery/computer/aifixer,
/obj/effect/turf_decal/tile/purple{
	dir = 1
	},
/obj/effect/turf_decal/tile/purple,
/obj/effect/turf_decal/tile/purple{
	dir = 4
	},
/obj/effect/turf_decal/tile/purple{
	dir = 8
	},
/turf/open/floor/plasteel/dark,
/area/shuttle/escape)
"gU" = (
/obj/effect/turf_decal/tile/red{
	dir = 1
	},
/obj/effect/turf_decal/tile/red{
	dir = 4
	},
/turf/open/floor/plasteel/dark,
/area/shuttle/escape)
"gZ" = (
/obj/machinery/light{
	dir = 8
	},
/turf/open/floor/plasteel,
/area/shuttle/escape)
"hn" = (
/turf/open/floor/plasteel,
/area/shuttle/escape)
"hu" = (
/obj/structure/toilet{
	dir = 4
	},
/obj/structure/reagent_dispensers/peppertank{
	pixel_x = -32
	},
/turf/open/floor/mineral/plastitanium/red/brig,
/area/shuttle/escape)
"hE" = (
/obj/structure/table,
/obj/effect/turf_decal/tile/blue{
	dir = 1
	},
/obj/effect/turf_decal/tile/blue,
/obj/effect/turf_decal/tile/blue{
	dir = 4
	},
/obj/effect/turf_decal/tile/blue{
	dir = 8
	},
/turf/open/floor/plasteel/dark,
/area/shuttle/escape)
"ig" = (
/obj/structure/sink{
	dir = 4;
	pixel_x = 12;
	pixel_y = 2
	},
/obj/structure/mirror{
	pixel_x = 28
	},
/turf/open/floor/plasteel,
/area/shuttle/escape)
"iz" = (
/obj/structure/toilet{
	dir = 8
	},
/obj/machinery/light/small{
	dir = 4
	},
/turf/open/floor/plasteel/freezer,
/area/shuttle/escape)
"iD" = (
/turf/open/floor/plasteel/freezer,
/area/shuttle/escape)
"iI" = (
/obj/structure/table,
/obj/machinery/recharger,
/turf/open/floor/mineral/plastitanium/red/brig,
/area/shuttle/escape)
"iL" = (
/obj/structure/table,
/obj/structure/bedsheetbin/towel,
/turf/open/floor/plasteel,
/area/shuttle/escape)
"ji" = (
/obj/effect/turf_decal/tile/blue{
	dir = 1
	},
/obj/effect/turf_decal/tile/blue{
	dir = 4
	},
/turf/open/floor/plasteel/dark,
/area/shuttle/escape)
"jY" = (
/obj/structure/table,
/obj/item/paper_bin,
/obj/item/pen,
/obj/effect/turf_decal/tile/purple{
	dir = 1
	},
/obj/effect/turf_decal/tile/purple,
/obj/effect/turf_decal/tile/purple{
	dir = 4
	},
/obj/effect/turf_decal/tile/purple{
	dir = 8
	},
/turf/open/floor/plasteel/dark,
/area/shuttle/escape)
"kg" = (
/obj/machinery/light,
/turf/open/floor/plasteel/dark,
/area/shuttle/escape)
"kA" = (
/obj/machinery/shower,
/turf/open/floor/plasteel/freezer,
/area/shuttle/escape)
"kP" = (
/obj/structure/table,
/obj/effect/turf_decal/tile/yellow{
	dir = 1
	},
/obj/effect/turf_decal/tile/yellow,
/obj/effect/turf_decal/tile/yellow{
	dir = 4
	},
/obj/effect/turf_decal/tile/yellow{
	dir = 8
	},
/turf/open/floor/plasteel/dark,
/area/shuttle/escape)
"kV" = (
/turf/open/floor/plasteel/white,
/area/shuttle/escape)
"lr" = (
/obj/structure/toilet{
	dir = 1
	},
/turf/open/floor/plasteel/freezer,
/area/shuttle/escape)
"lH" = (
/obj/structure/table,
/obj/item/reagent_containers/glass/beaker/cryoxadone,
/obj/item/wrench,
/obj/effect/turf_decal/tile/blue{
	dir = 1
	},
/obj/effect/turf_decal/tile/blue,
/obj/effect/turf_decal/tile/blue{
	dir = 4
	},
/turf/open/floor/plasteel/white,
/area/shuttle/escape)
"lR" = (
/obj/structure/sink{
	dir = 8;
	pixel_x = -12;
	pixel_y = 2
	},
/obj/structure/mirror{
	pixel_x = -28
	},
/turf/open/floor/plasteel,
/area/shuttle/escape)
"mb" = (
/obj/machinery/shower{
	dir = 1
	},
/turf/open/floor/plasteel/freezer,
/area/shuttle/escape)
"mI" = (
/obj/structure/toilet,
/obj/structure/window/reinforced/tinted{
	dir = 4
	},
/turf/open/floor/plasteel/freezer,
/area/shuttle/escape)
"nd" = (
/obj/structure/window/reinforced{
	dir = 1
	},
/obj/structure/shuttle/engine/heater,
/turf/open/floor/plating/airless,
/area/shuttle/escape)
"nP" = (
/obj/structure/sink/puddle,
/turf/open/floor/plasteel/freezer,
/area/shuttle/escape)
"oj" = (
/obj/structure/table,
/obj/item/storage/firstaid/regular{
	pixel_x = 2;
	pixel_y = 3
	},
/obj/effect/turf_decal/tile/blue,
/obj/effect/turf_decal/tile/blue{
	dir = 4
	},
/turf/open/floor/plasteel/white,
/area/shuttle/escape)
"op" = (
/obj/structure/window/reinforced{
	dir = 8
	},
/obj/structure/window/reinforced,
/turf/open/floor/plasteel/dark,
/area/shuttle/escape)
"ox" = (
/obj/machinery/power/port_gen/pacman,
/turf/open/floor/plating,
/area/shuttle/escape)
"pD" = (
/obj/structure/toilet,
/obj/structure/window/reinforced/tinted{
	dir = 8
	},
/turf/open/floor/plasteel/freezer,
/area/shuttle/escape)
"pT" = (
/turf/closed/wall/mineral/titanium/nodiagonal,
/area/shuttle/escape)
"pX" = (
/obj/effect/turf_decal/tile/blue{
	dir = 1
	},
/obj/effect/turf_decal/tile/blue,
/obj/effect/turf_decal/tile/blue{
	dir = 4
	},
/obj/effect/turf_decal/tile/blue{
	dir = 8
	},
/turf/open/floor/plasteel/dark,
/area/shuttle/escape)
"pZ" = (
/obj/structure/chair/comfy/beige{
	dir = 1
	},
/obj/effect/turf_decal/tile/yellow{
	dir = 1
	},
/obj/effect/turf_decal/tile/yellow,
/obj/effect/turf_decal/tile/yellow{
	dir = 4
	},
/obj/effect/turf_decal/tile/yellow{
	dir = 8
	},
/turf/open/floor/plasteel/dark,
/area/shuttle/escape)
"qr" = (
/obj/effect/turf_decal/tile/purple{
	dir = 1
	},
/obj/effect/turf_decal/tile/purple{
	dir = 4
	},
/turf/open/floor/plasteel/dark,
/area/shuttle/escape)
"rc" = (
/obj/structure/toilet{
	dir = 4
	},
/turf/open/floor/plasteel/freezer,
/area/shuttle/escape)
"rR" = (
/obj/structure/table,
/obj/item/storage/firstaid/regular{
	pixel_x = 2;
	pixel_y = 3
	},
/obj/machinery/light{
	dir = 4
	},
/turf/open/floor/plasteel,
/area/shuttle/escape)
"sW" = (
/obj/machinery/light{
	dir = 1
	},
/obj/structure/toilet,
/turf/open/floor/mineral/plastitanium/red/brig,
/area/shuttle/escape)
"tc" = (
/obj/structure/reagent_dispensers/fueltank,
/turf/open/floor/plating,
/area/shuttle/escape)
"tu" = (
/obj/structure/table/optable,
/obj/effect/turf_decal/tile/blue{
	dir = 1
	},
/obj/effect/turf_decal/tile/blue,
/obj/effect/turf_decal/tile/blue{
	dir = 4
	},
/obj/effect/turf_decal/tile/blue{
	dir = 8
	},
/turf/open/floor/plasteel/white,
/area/shuttle/escape)
"tY" = (
/obj/structure/toilet{
	dir = 1
	},
/obj/structure/window/reinforced/tinted{
	dir = 4
	},
/turf/open/floor/plasteel/freezer,
/area/shuttle/escape)
"uh" = (
/obj/structure/toilet{
	dir = 1
	},
/obj/structure/window/reinforced/tinted{
	dir = 8
	},
/turf/open/floor/plasteel/freezer,
/area/shuttle/escape)
"vp" = (
/obj/structure/table,
/obj/structure/window/reinforced{
	dir = 8
	},
/turf/open/floor/plasteel/dark,
/area/shuttle/escape)
"vx" = (
/obj/machinery/door/airlock/maintenance_hatch,
/turf/open/floor/plating,
/area/shuttle/escape)
"vB" = (
/obj/machinery/atmospherics/components/unary/thermomachine/freezer,
/obj/effect/turf_decal/tile/blue{
	dir = 1
	},
/obj/effect/turf_decal/tile/blue{
	dir = 4
	},
/turf/open/floor/plasteel/white,
/area/shuttle/escape)
"vC" = (
/obj/machinery/atmospherics/pipe/simple/general/visible{
	dir = 9
	},
/turf/open/floor/plasteel/white,
/area/shuttle/escape)
"vO" = (
/obj/structure/chair/comfy/beige{
	dir = 8
	},
/obj/effect/turf_decal/tile/blue{
	dir = 1
	},
/obj/effect/turf_decal/tile/blue,
/obj/effect/turf_decal/tile/blue{
	dir = 4
	},
/obj/effect/turf_decal/tile/blue{
	dir = 8
	},
/turf/open/floor/plasteel/dark,
/area/shuttle/escape)
"wB" = (
/obj/machinery/computer/communications{
	dir = 8
	},
/obj/structure/window/reinforced{
	dir = 4
	},
/turf/open/floor/plasteel/dark,
/area/shuttle/escape)
"xn" = (
/obj/structure/table,
/obj/item/storage/firstaid/o2,
/obj/item/storage/firstaid/toxin,
/obj/effect/turf_decal/tile/blue{
	dir = 1
	},
/obj/effect/turf_decal/tile/blue,
/obj/effect/turf_decal/tile/blue{
	dir = 8
	},
/turf/open/floor/plasteel/white,
/area/shuttle/escape)
"xx" = (
/obj/effect/turf_decal/tile/yellow{
	dir = 1
	},
/obj/effect/turf_decal/tile/yellow{
	dir = 4
	},
/turf/open/floor/plasteel/dark,
/area/shuttle/escape)
"xO" = (
/obj/machinery/light/small{
	dir = 4
	},
/obj/machinery/recharge_station,
/turf/open/floor/plasteel/freezer,
/area/shuttle/escape)
"yp" = (
/obj/machinery/computer/med_data{
	dir = 4
	},
/obj/effect/turf_decal/tile/blue{
	dir = 1
	},
/obj/effect/turf_decal/tile/blue,
/obj/effect/turf_decal/tile/blue{
	dir = 4
	},
/obj/effect/turf_decal/tile/blue{
	dir = 8
	},
/turf/open/floor/plasteel/dark,
/area/shuttle/escape)
"yX" = (
/obj/structure/window/reinforced{
	dir = 4
	},
/obj/structure/window/reinforced,
/turf/open/floor/plasteel/dark,
/area/shuttle/escape)
"Ar" = (
/obj/structure/table,
/turf/open/floor/plasteel,
/area/shuttle/escape)
"At" = (
/turf/template_noop,
/area/template_noop)
"Bb" = (
/obj/structure/toilet{
	dir = 8
	},
/turf/open/floor/plasteel/freezer,
/area/shuttle/escape)
"Bq" = (
/obj/machinery/door/airlock{
	name = "Bathroom"
	},
/turf/open/floor/plasteel/freezer,
/area/shuttle/escape)
"Bt" = (
/obj/structure/shuttle/engine/propulsion,
/turf/open/floor/plating/airless,
/area/shuttle/escape)
"BM" = (
/obj/item/radio/intercom{
	name = "Station Intercom (General)";
	pixel_y = -29
	},
/turf/open/floor/plasteel,
/area/shuttle/escape)
"BR" = (
/obj/structure/table,
/obj/structure/window/reinforced{
	dir = 4
	},
/obj/item/clothing/suit/apron/surgical,
/obj/item/clothing/gloves/color/latex,
/obj/item/clothing/mask/surgical,
/obj/effect/turf_decal/tile/blue{
	dir = 4
	},
/obj/effect/turf_decal/tile/blue{
	dir = 1
	},
/obj/effect/turf_decal/tile/blue,
/obj/effect/turf_decal/tile/blue{
	dir = 8
	},
/turf/open/floor/plasteel/white,
/area/shuttle/escape)
"Cm" = (
/obj/structure/chair/comfy/shuttle{
	dir = 8
	},
/obj/structure/window/reinforced{
	dir = 4
	},
/obj/effect/turf_decal/tile/neutral{
	dir = 1
	},
/obj/effect/turf_decal/tile/neutral,
/obj/effect/turf_decal/tile/neutral{
	dir = 4
	},
/obj/effect/turf_decal/tile/neutral{
	dir = 8
	},
/turf/open/floor/plasteel,
/area/shuttle/escape)
"CA" = (
/obj/machinery/atmospherics/components/unary/portables_connector/visible,
/obj/machinery/portable_atmospherics/canister/oxygen,
/obj/effect/turf_decal/tile/blue{
	dir = 1
	},
/obj/effect/turf_decal/tile/blue{
	dir = 4
	},
/turf/open/floor/plasteel/white,
/area/shuttle/escape)
"CO" = (
/obj/structure/window/reinforced{
	dir = 4
	},
/obj/structure/window/reinforced{
	dir = 1;
	pixel_y = 1
	},
/obj/machinery/iv_drip,
/obj/effect/turf_decal/tile/blue{
	dir = 1
	},
/obj/effect/turf_decal/tile/blue,
/obj/effect/turf_decal/tile/blue{
	dir = 4
	},
/obj/effect/turf_decal/tile/blue{
	dir = 8
	},
/turf/open/floor/plasteel/white,
/area/shuttle/escape)
"CQ" = (
/obj/structure/chair/office/light{
	dir = 1
	},
/turf/open/floor/plasteel/dark,
/area/shuttle/escape)
"CR" = (
/obj/structure/extinguisher_cabinet{
	pixel_y = -30
	},
/turf/open/floor/plasteel/dark,
/area/shuttle/escape)
"Db" = (
/obj/machinery/light,
/turf/open/floor/plasteel,
/area/shuttle/escape)
"Dl" = (
/obj/machinery/sleeper{
	dir = 8
	},
/obj/machinery/light{
	dir = 4
	},
/obj/effect/turf_decal/tile/blue{
	dir = 1
	},
/obj/effect/turf_decal/tile/blue,
/obj/effect/turf_decal/tile/blue{
	dir = 4
	},
/turf/open/floor/plasteel/white,
/area/shuttle/escape)
"Dm" = (
/obj/structure/chair/comfy/shuttle{
	dir = 4
	},
/obj/structure/window/reinforced{
	dir = 8
	},
/obj/effect/turf_decal/tile/neutral{
	dir = 1
	},
/obj/effect/turf_decal/tile/neutral,
/obj/effect/turf_decal/tile/neutral{
	dir = 4
	},
/obj/effect/turf_decal/tile/neutral{
	dir = 8
	},
/turf/open/floor/plasteel,
/area/shuttle/escape)
"DN" = (
/obj/item/twohanded/required/kirbyplants{
	icon_state = "plant-22"
	},
/obj/item/radio/intercom{
	name = "Station Intercom (General)";
	pixel_y = -29
	},
/obj/effect/turf_decal/tile/blue{
	dir = 1
	},
/obj/effect/turf_decal/tile/blue{
	dir = 4
	},
/turf/open/floor/plasteel/dark,
/area/shuttle/escape)
"DS" = (
/obj/effect/spawner/structure/window/shuttle,
/turf/open/floor/plating,
/area/shuttle/escape)
"Ed" = (
/obj/machinery/sleeper{
	dir = 8
	},
/obj/effect/turf_decal/tile/blue,
/obj/effect/turf_decal/tile/blue{
	dir = 4
	},
/obj/effect/turf_decal/tile/blue{
	dir = 8
	},
/turf/open/floor/plasteel/white,
/area/shuttle/escape)
"Eq" = (
/obj/effect/turf_decal/tile/blue{
	dir = 4
	},
/turf/open/floor/plasteel/white,
/area/shuttle/escape)
"FB" = (
/obj/structure/table,
/obj/structure/window/reinforced{
	dir = 4
	},
/turf/open/floor/plasteel/dark,
/area/shuttle/escape)
"FC" = (
/obj/structure/table,
/obj/item/storage/box/donkpockets,
/obj/item/storage/box/donkpockets,
/obj/effect/turf_decal/tile/neutral{
	dir = 1
	},
/obj/effect/turf_decal/tile/neutral,
/obj/effect/turf_decal/tile/neutral{
	dir = 4
	},
/obj/effect/turf_decal/tile/neutral{
	dir = 8
	},
/turf/open/floor/plasteel,
/area/shuttle/escape)
"Gr" = (
/obj/item/twohanded/required/kirbyplants{
	icon_state = "plant-21"
	},
/turf/open/floor/plasteel,
/area/shuttle/escape)
"Gz" = (
/obj/structure/table,
/obj/item/storage/box/cups,
/obj/item/radio/intercom{
	dir = 4;
	name = "Station Intercom (General)";
	pixel_y = 27
	},
/obj/effect/turf_decal/tile/neutral{
	dir = 1
	},
/obj/effect/turf_decal/tile/neutral,
/obj/effect/turf_decal/tile/neutral{
	dir = 4
	},
/obj/effect/turf_decal/tile/neutral{
	dir = 8
	},
/turf/open/floor/plasteel,
/area/shuttle/escape)
"GN" = (
/obj/machinery/power/smes/engineering,
/turf/open/floor/plating,
/area/shuttle/escape)
"Ht" = (
/obj/item/radio/intercom{
	name = "Station Intercom (General)";
	pixel_y = -29
	},
/obj/effect/turf_decal/tile/blue,
/obj/effect/turf_decal/tile/blue{
	dir = 8
	},
/turf/open/floor/plasteel/white,
/area/shuttle/escape)
"Hx" = (
/obj/structure/extinguisher_cabinet{
	pixel_y = -30
	},
/turf/open/floor/plasteel,
/area/shuttle/escape)
"HB" = (
/obj/structure/urinal{
	pixel_x = -32
	},
/turf/open/floor/plasteel/freezer,
/area/shuttle/escape)
"HX" = (
/obj/item/radio/intercom{
	dir = 4;
	name = "Station Intercom (General)";
	pixel_y = 27
	},
/turf/open/floor/plasteel,
/area/shuttle/escape)
"Ii" = (
/obj/structure/table,
/obj/structure/window/reinforced{
	dir = 4
	},
/obj/item/storage/backpack/duffelbag/med/surgery,
/obj/effect/turf_decal/tile/blue{
	dir = 4
	},
/obj/effect/turf_decal/tile/blue{
	dir = 1
	},
/obj/effect/turf_decal/tile/blue{
	dir = 8
	},
/obj/effect/turf_decal/tile/blue,
/turf/open/floor/plasteel/white,
/area/shuttle/escape)
"Is" = (
/obj/effect/turf_decal/tile/yellow{
	dir = 1
	},
/obj/effect/turf_decal/tile/yellow,
/obj/effect/turf_decal/tile/yellow{
	dir = 4
	},
/obj/effect/turf_decal/tile/yellow{
	dir = 8
	},
/turf/open/floor/plasteel/dark,
/area/shuttle/escape)
"IJ" = (
/obj/machinery/atmospherics/pipe/manifold/general/visible,
/turf/open/floor/plasteel/white,
/area/shuttle/escape)
"IK" = (
/obj/machinery/computer/station_alert{
	dir = 4
	},
/obj/structure/window/reinforced{
	dir = 8
	},
/turf/open/floor/plasteel/dark,
/area/shuttle/escape)
"IU" = (
/obj/structure/sign/warning/electricshock{
	pixel_x = 32
	},
/turf/open/floor/plasteel,
/area/shuttle/escape)
"Jh" = (
/obj/structure/sign/warning/enginesafety{
	pixel_y = 32
	},
/turf/open/floor/plating,
/area/shuttle/escape)
"Jp" = (
/obj/machinery/flasher{
	id = "shuttle_flasher";
	pixel_x = 24;
	pixel_y = 6
	},
/obj/structure/toilet{
	dir = 8
	},
/turf/open/floor/mineral/plastitanium/red/brig,
/area/shuttle/escape)
"KZ" = (
/obj/structure/table,
/obj/item/storage/firstaid/regular{
	pixel_x = 2;
	pixel_y = 3
	},
/obj/item/storage/firstaid/o2,
/obj/machinery/light{
	dir = 1
	},
/obj/effect/turf_decal/tile/yellow{
	dir = 1
	},
/obj/effect/turf_decal/tile/yellow,
/obj/effect/turf_decal/tile/yellow{
	dir = 4
	},
/obj/effect/turf_decal/tile/yellow{
	dir = 8
	},
/turf/open/floor/plasteel/dark,
/area/shuttle/escape)
"Lh" = (
/obj/machinery/atmospherics/components/unary/cryo_cell,
/obj/effect/turf_decal/tile/blue{
	dir = 1
	},
/obj/effect/turf_decal/tile/blue{
	dir = 4
	},
/turf/open/floor/plasteel/white,
/area/shuttle/escape)
"Mr" = (
/obj/machinery/light{
	dir = 4
	},
/obj/item/twohanded/required/kirbyplants{
	icon_state = "plant-21"
	},
/turf/open/floor/plasteel,
/area/shuttle/escape)
"Or" = (
/obj/structure/table,
/obj/item/book/manual/wiki/security_space_law,
/obj/effect/turf_decal/tile/red{
	dir = 1
	},
/obj/effect/turf_decal/tile/red,
/obj/effect/turf_decal/tile/red{
	dir = 4
	},
/obj/effect/turf_decal/tile/red{
	dir = 8
	},
/turf/open/floor/plasteel/dark,
/area/shuttle/escape)
"OH" = (
/obj/machinery/sleeper{
	dir = 8
	},
/obj/effect/turf_decal/tile/blue,
/obj/effect/turf_decal/tile/blue{
	dir = 4
	},
/turf/open/floor/plasteel/white,
/area/shuttle/escape)
"OX" = (
/obj/effect/turf_decal/tile/blue{
	dir = 8
	},
/turf/open/floor/plasteel/white,
/area/shuttle/escape)
"Pc" = (
/obj/structure/toilet{
	dir = 4
	},
/turf/open/floor/mineral/plastitanium/red/brig,
/area/shuttle/escape)
"Pv" = (
/obj/machinery/light/small{
	dir = 1
	},
/turf/open/floor/plating,
/area/shuttle/escape)
"PP" = (
/turf/open/floor/plasteel/dark,
/area/shuttle/escape)
"QM" = (
/obj/structure/table,
/obj/machinery/recharger,
/obj/effect/turf_decal/tile/red{
	dir = 1
	},
/obj/effect/turf_decal/tile/red,
/obj/effect/turf_decal/tile/red{
	dir = 4
	},
/obj/effect/turf_decal/tile/red{
	dir = 8
	},
/turf/open/floor/plasteel/dark,
/area/shuttle/escape)
"QT" = (
/obj/structure/table,
/obj/item/paper_bin,
/obj/item/pen,
/obj/machinery/light{
	dir = 1
	},
/obj/effect/turf_decal/tile/neutral{
	dir = 1
	},
/obj/effect/turf_decal/tile/neutral,
/obj/effect/turf_decal/tile/neutral{
	dir = 4
	},
/obj/effect/turf_decal/tile/neutral{
	dir = 8
	},
/turf/open/floor/plasteel,
/area/shuttle/escape)
"QZ" = (
/obj/structure/table,
/obj/machinery/microwave,
/obj/effect/turf_decal/tile/neutral{
	dir = 1
	},
/obj/effect/turf_decal/tile/neutral,
/obj/effect/turf_decal/tile/neutral{
	dir = 4
	},
/obj/effect/turf_decal/tile/neutral{
	dir = 8
	},
/turf/open/floor/plasteel,
/area/shuttle/escape)
"RE" = (
/obj/machinery/atmospherics/pipe/simple/general/visible{
	dir = 5
	},
/turf/open/floor/plasteel/white,
/area/shuttle/escape)
"RV" = (
/obj/machinery/computer/card,
/turf/open/floor/plasteel/dark,
/area/shuttle/escape)
"Sl" = (
/obj/effect/turf_decal/tile/red{
	dir = 1
	},
/obj/effect/turf_decal/tile/red,
/obj/effect/turf_decal/tile/red{
	dir = 4
	},
/obj/effect/turf_decal/tile/red{
	dir = 8
	},
/turf/open/floor/plasteel/dark,
/area/shuttle/escape)
"Sz" = (
/obj/structure/reagent_dispensers/watertank,
/turf/open/floor/plating,
/area/shuttle/escape)
"Tm" = (
/obj/effect/turf_decal/tile/blue{
	dir = 1
	},
/obj/effect/turf_decal/tile/blue{
	dir = 8
	},
/turf/open/floor/plasteel/white,
/area/shuttle/escape)
"Tq" = (
/obj/machinery/door/airlock/shuttle{
	name = "Emergency Shuttle Airlock"
	},
/obj/docking_port/mobile/emergency{
	dwidth = 15;
	height = 20;
	name = "Cere emergency shuttle";
	width = 42
	},
/obj/structure/fans/tiny,
/turf/open/floor/plating,
/area/shuttle/escape)
"Tu" = (
/obj/machinery/light{
	dir = 4
	},
/turf/open/floor/plasteel/freezer,
/area/shuttle/escape)
"Tv" = (
/obj/effect/turf_decal/tile/purple{
	dir = 1
	},
/obj/effect/turf_decal/tile/purple,
/obj/effect/turf_decal/tile/purple{
	dir = 4
	},
/obj/effect/turf_decal/tile/purple{
	dir = 8
	},
/turf/open/floor/plasteel/dark,
/area/shuttle/escape)
"Tz" = (
/obj/machinery/door/airlock/public/glass{
	name = "Emergency Shuttle Brig";
	req_access_txt = "2"
	},
/turf/open/floor/mineral/plastitanium/red/brig,
/area/shuttle/escape)
"Ug" = (
/obj/structure/urinal{
	pixel_y = -32
	},
/turf/open/floor/plasteel,
/area/shuttle/escape)
"Ur" = (
/obj/item/twohanded/required/kirbyplants{
	icon_state = "plant-22"
	},
/obj/item/radio/intercom{
	name = "Station Intercom (General)";
	pixel_y = -29
	},
/obj/effect/turf_decal/tile/red{
	dir = 1
	},
/obj/effect/turf_decal/tile/red{
	dir = 4
	},
/turf/open/floor/plasteel/dark,
/area/shuttle/escape)
"UE" = (
/obj/structure/table,
/obj/machinery/recharger,
/turf/open/floor/mineral/plastitanium/red/brig,
/area/shuttle/escape)
"Vg" = (
/obj/effect/turf_decal/tile/neutral{
	dir = 1
	},
/obj/effect/turf_decal/tile/neutral{
	dir = 4
	},
/turf/open/floor/plasteel,
/area/shuttle/escape)
"VD" = (
/obj/machinery/power/terminal{
	dir = 4
	},
/turf/open/floor/plating,
/area/shuttle/escape)
"Wi" = (
/obj/machinery/door/airlock/shuttle{
	name = "Emergency Shuttle Airlock";
	req_access_txt = "2"
	},
/obj/structure/fans/tiny,
/turf/open/floor/plating,
/area/shuttle/escape)
"Wn" = (
/obj/effect/turf_decal/tile/blue{
	dir = 1
	},
/obj/effect/turf_decal/tile/blue,
/obj/effect/turf_decal/tile/blue{
	dir = 4
	},
/obj/effect/turf_decal/tile/blue{
	dir = 8
	},
/turf/open/floor/plasteel/white,
/area/shuttle/escape)
"WL" = (
/turf/open/floor/mineral/plastitanium/red/brig,
/area/shuttle/escape)
"WV" = (
/obj/structure/table,
/obj/item/storage/firstaid/fire,
/obj/item/crowbar,
/obj/effect/turf_decal/tile/blue,
/obj/effect/turf_decal/tile/blue{
	dir = 4
	},
/turf/open/floor/plasteel/white,
/area/shuttle/escape)
"WZ" = (
/obj/structure/closet/crate/bin,
/obj/effect/turf_decal/tile/neutral{
	dir = 1
	},
/obj/effect/turf_decal/tile/neutral,
/obj/effect/turf_decal/tile/neutral{
	dir = 4
	},
/obj/effect/turf_decal/tile/neutral{
	dir = 8
	},
/turf/open/floor/plasteel,
/area/shuttle/escape)
"Xi" = (
/obj/machinery/computer/security{
	dir = 8
	},
/obj/effect/turf_decal/tile/red{
	dir = 1
	},
/obj/effect/turf_decal/tile/red,
/obj/effect/turf_decal/tile/red{
	dir = 4
	},
/obj/effect/turf_decal/tile/red{
	dir = 8
	},
/turf/open/floor/plasteel/dark,
/area/shuttle/escape)
"XK" = (
/obj/machinery/door/airlock/shuttle{
	name = "Emergency Shuttle Airlock"
	},
/obj/structure/fans/tiny,
/turf/open/floor/plating,
/area/shuttle/escape)
"XL" = (
/obj/machinery/door/airlock/medical/glass{
	name = "Emergency Shuttle Medbay"
	},
/obj/effect/turf_decal/tile/blue{
	dir = 1
	},
/obj/effect/turf_decal/tile/blue,
/obj/effect/turf_decal/tile/blue{
	dir = 4
	},
/obj/effect/turf_decal/tile/blue{
	dir = 8
	},
/turf/open/floor/plasteel/white,
/area/shuttle/escape)
"Yl" = (
/obj/machinery/sleeper{
	dir = 1
	},
/obj/effect/turf_decal/tile/blue,
/obj/effect/turf_decal/tile/blue{
	dir = 8
	},
/turf/open/floor/plasteel/white,
/area/shuttle/escape)
"Yo" = (
/obj/machinery/computer/emergency_shuttle,
/turf/open/floor/plasteel/dark,
/area/shuttle/escape)
"Zh" = (
/obj/effect/turf_decal/tile/neutral,
/obj/effect/turf_decal/tile/neutral{
	dir = 8
	},
/turf/open/floor/plasteel,
/area/shuttle/escape)
"ZD" = (
/obj/effect/turf_decal/tile/neutral,
/obj/effect/turf_decal/tile/neutral{
	dir = 4
	},
/turf/open/floor/plasteel,
/area/shuttle/escape)

(1,1,1) = {"
At
At
At
At
At
At
At
co
co
co
co
co
co
Wi
co
Tq
co
At
At
At
co
XK
co
XK
co
At
At
co
co
DS
DS
DS
DS
DS
co
co
co
co
At
At
At
At
"}
(2,1,1) = {"
At
At
At
At
At
co
co
co
co
UE
Pc
hu
gB
WL
co
hn
pT
DS
DS
DS
pT
hn
bd
hn
pT
co
co
pT
hn
hn
hn
hn
Ar
Gr
co
HB
HB
pT
co
co
At
At
"}
(3,1,1) = {"
At
At
co
co
co
co
co
co
co
sW
WL
WL
WL
WL
co
hn
gZ
hn
hn
hn
gZ
hn
hn
hn
gZ
hn
hn
gZ
hn
hn
hn
hn
hn
hn
dz
hn
hn
hn
pT
co
co
co
"}
(4,1,1) = {"
At
co
co
co
co
co
co
co
co
af
Jp
UE
WL
WL
co
ZD
co
ig
ig
ig
co
hn
hn
hn
co
ig
ig
co
co
co
co
co
co
co
co
co
hn
hn
Ug
co
nd
Bt
"}
(5,1,1) = {"
co
co
co
pT
hE
yp
dw
hE
co
co
co
DS
Tz
DS
co
WZ
co
co
co
co
co
hn
hn
hn
co
co
co
co
rc
co
rc
co
rc
co
rc
co
hn
hn
Ug
co
nd
Bt
"}
(6,1,1) = {"
At
At
co
ex
pX
pX
vO
DN
co
hn
hn
hn
hn
hn
hn
Gz
hn
hn
hn
hn
hn
hn
hn
hn
hn
hn
hn
co
iD
co
iD
co
iD
co
iD
co
hn
hn
hn
co
nd
Bt
"}
(7,1,1) = {"
At
At
DS
gF
fZ
pX
ji
kg
co
hn
hn
hn
hn
hn
hn
dm
hn
hn
hn
hn
hn
hn
hn
hn
hn
hn
hn
hn
hn
hn
hn
hn
hn
hn
hn
hn
hn
hn
BM
co
nd
Bt
"}
(8,1,1) = {"
At
At
DS
jY
Tv
qr
PP
PP
co
aj
hn
hn
hn
hn
hn
QZ
Vg
Zh
Cm
Cm
co
iL
hn
iL
co
hn
hn
hn
hn
hn
hn
hn
hn
hn
hn
hn
hn
hn
hn
co
nd
Bt
"}
(9,1,1) = {"
At
At
DS
vp
IK
op
PP
PP
co
hn
hn
hn
hn
hn
hn
FC
Vg
Zh
Dm
Dm
co
co
hn
co
co
co
co
iD
iD
co
co
co
iD
co
iD
co
hn
hn
hn
co
nd
Bt
"}
(10,1,1) = {"
At
At
DS
RV
CQ
PP
PP
PP
co
hn
hn
hn
hn
hn
hn
QT
Vg
hn
bz
bz
co
kA
iD
mb
co
mI
iD
iD
iD
iD
tY
co
Bb
co
Bb
co
hn
hn
Db
co
pT
pT
"}
(11,1,1) = {"
At
At
DS
Yo
CQ
PP
PP
CR
co
hn
hn
hn
hn
hn
hn
bz
hn
hn
ZD
ZD
co
iD
iD
mb
co
nP
iD
iD
iD
iD
lr
co
co
co
co
co
hn
IU
Hx
co
pT
pT
"}
(12,1,1) = {"
At
At
DS
FB
wB
yX
PP
PP
ei
hn
hn
hn
hn
hn
hn
hn
hn
Zh
Cm
Cm
co
iD
iD
mb
co
pD
iD
iD
iD
iD
uh
co
rc
co
rc
co
co
co
vx
pT
nd
Bt
"}
(13,1,1) = {"
At
At
DS
kP
Is
xx
PP
PP
ei
hn
hn
hn
hn
hn
hn
hn
hn
Zh
Dm
Dm
co
co
co
co
co
co
co
iD
iD
co
co
co
iD
co
iD
co
iD
co
Jh
tc
nd
Bt
"}
(14,1,1) = {"
At
At
DS
eZ
pZ
Sl
gU
kg
co
co
co
co
co
co
PP
co
pT
Zh
Zh
Zh
iD
lr
co
ck
iD
Vg
XL
cx
kV
fg
Wn
Wn
tu
co
iD
iD
iD
co
dz
Sz
nd
Bt
"}
(15,1,1) = {"
At
At
co
KZ
Sl
Sl
cI
Ur
co
ck
iD
iD
iD
co
hn
hn
co
Zh
Cm
Cm
co
co
co
co
co
Vg
DS
CA
RE
fg
CO
Ii
BR
co
iD
iD
iD
co
Pv
ox
nd
Bt
"}
(16,1,1) = {"
co
co
co
pT
Or
Xi
bw
QM
co
co
co
iD
iD
iD
hn
hn
co
Zh
Dm
Dm
co
lR
lR
lR
co
Vg
co
Lh
IJ
OX
Tm
Tm
xn
co
iD
iD
iD
co
VD
VD
nd
Bt
"}
(17,1,1) = {"
At
co
co
co
co
co
co
co
co
ck
iD
iD
iD
co
hn
hn
co
HX
bz
bz
bz
bz
bz
bz
bz
hn
DS
vB
vC
kV
kV
kV
Yl
co
iD
Tu
iD
co
GN
GN
nd
Bt
"}
(18,1,1) = {"
At
At
co
co
co
co
co
co
co
co
co
iD
iD
iD
hn
hn
co
rR
hn
hn
hn
hn
hn
hn
hn
Mr
co
lH
Eq
kV
kV
kV
Ht
co
Bq
co
Bq
co
co
co
co
co
"}
(19,1,1) = {"
At
At
At
At
At
co
co
co
co
ck
iD
iD
iD
co
hn
hn
co
co
DS
DS
DS
DS
DS
DS
DS
co
co
pT
Dl
oj
OH
WV
Ed
co
iz
co
xO
co
co
co
At
At
"}
(20,1,1) = {"
At
At
At
At
At
At
At
co
co
co
co
co
co
co
co
co
co
At
At
At
At
At
At
At
At
At
At
co
co
DS
DS
DS
co
co
co
co
co
co
At
At
At
At
"}
